1111111
10000C1
10E0001
1PC0001
1111111
