1111111
100C111
10EP111
1111111
