111111111111111111111111111
100P00000000011111111111111
100000000000011111111111111
100000000011111111111111111
100000110000011111111111111
100000000000000000000000001
100111111111111110000000001
100000000000000000000000001
1000E0000000010000000000001
1000000C0000100000100000001
100000000001000000100000001
100000000010000000111110001
100000000100000000100000001
100000001000000000000000001
111111111110000000000010011
1000000000000000000000100C1
111111111111111111111111111
