111111111111111111111111111
1000000000C0011111111111111
100000000000011111111111111
100C00000011111111111111111
100P00110000011111111111111
100000000000000000000000001
100111111111111110000000001
100C00000000000000000000001
100000000000010000000000001
100000000000100000100000001
100000000001000000100000001
10000C000010000000111110001
100000000100000000100000001
10000000100000000C000000001
111111111110000000000010001
1E0000000000000000000010001
111111111111111111111111111
