111111111111111111111111111111111111111111111111111111111111111111111111111111111111111111111111111111111111111111111111111111111111111111111111111111111111111111111111
100000000000000000000000000000000000000000000000000000000000000000000000000000000000000000000000000000000000000000000000000000000000000000000000000000000000000000000001
111000000001111111111111111111111111000000000000000000000000000000000000000000000000000000000000000000000000000000000000000000000000000000000000000000000000000000000001
100000000000000000000000000000000001000000000000000000000000000000000000000000011111111111111111111111111111111111111111111111000000000000000000000000000000000000000001
100000000000000000111111111111100001000000000000000000000000000000000000000000000000000000000000000000000100000000000000000000000000000000000000000000000000000000000001
100000000000000000100000000000100001000000000000000000000000000000000000000000000000000000000000000000000100000000000000000000000000000000000000000000000000000000000001
100000000000000000100000111111100001000000000000111111111111111110000000000000000000000000000000000000000100C11111111111111111111111100000000000000000000000000000000001
100000000000000000100C001000000000010000000000000000001C00C0000010000000000000000000000000000000000000000100000100000001000000000000000000000100000000111111111111111111
100000000000000000100000000000000001000000000000000000111110000010000000000000000000000000000000000000000100000100000001000000000000000000000100000000010001000100000001
1000000000000000011111111111111111110000C00000000000000000000000100000000000000000000000000000000000000001000111000000010000000000000000000001000000000001000100011000C1
100000000000000000000000000000000001111111111111111111111111111110000000000000000000000000000000000000000100000000000001000000000000000000000111111111111111111111111111
100P0000000000000000000000000000000000000000000000000000000000000000000000000000000000000000000000000000011111111111111100000000000000000000010000000000000000C100000001
100000000000000000000000000000000000000000000000000000000000000000000000000000000000000000000000000000000000000000000000000000000000000000000100000000000000011100000001
100000000000000000000000000000000000000000000000000000000000000000000000000000000000000000000000000000000000000000000000000000000000000000000100000000000000000000000001
100000000000000000000000000000000000000000000000000000000000000000000000000000000000000000000000000000000000000000000000000000000000000000000000000000000000000000000001
100000000000000000000000000000000000000000000000000000000000000000000000000000000000000000000000000001111111111111111111111111111111111111111111111111111111111111111111
100000000000000000000000000000000000000000000000000000000000000000000000000000000000000000000000000000000000000000000000000000000000000000000000000000000000000000000001
111000000001111111111111111111111111000000000000000000000000000000000000000000000000000000000000000000000000000000000000000000000000000000000000000000000000000000000001
100000000000000000000000000000000001000000000000000000000000000000000000000000011111111111111111111111111111111111111111111111000000000000000000000000000000000000000001
100000000000000000111111111111100001000000000000000000000000000000000000000000000000000000000000000000000100000000000000000000000000000000000000000000000000000000000001
100000000000000000100000000000100001000000000000000000000000000000000000000000000000000000000000000000000100000000000000000000000000000000000000000000000000000000000001
100000000000000000100000111111100001000000000000111111111111111110000000000000000000000000000000000000000100C11111111111111111111111100000000000000000000000000000000001
100000000000000000100C001000000000010000000000000000001C00C0000010000000000000000000000000000000000000000100000100000001000000000000000000000100000000111111111111111111
100000000000000000100000000000000001000000000000000000111110000010000000000000000000000000000000000000000100000100000001000000000000000000000100000000010001000100000001
1000000000000000011111111111111111110000C00000000000000000000000100000000000000000000000000000000000000001000111000000010000000000000000000001000000000001000100011000C1
100000000000000000000000000000000001111111111111111111111111111110000000000000000000000000000000000000000100000000000001000000000000000000000111111111111111111111111111
10000000000000000000000000000000000000000000000000000000000000000000000000000000000000000000000000000000011111111111111100000000000000000000010000000000000000C100000001
100000000000000000000000000000000000000000000000000000000000000000000000000000000000000000000000000000000000000000000000000000000000000000000100000000000000011100000001
100000000000000000000000000000000000000000000000000000000000000000000000000000000000000000000000000000000000000000000000000000000000000000000100000000000000000000000001
100000000000000000000000000000000000000000000000000000000000000000000000000000000000000000000000000000000000000000000000000000000000000000000000000000000000000000000001
100000000000000000000000000000000000000000000000000000000000000000000000000000000000000000000000000001111111111111111111111111111111111111111111111111111111111111111111
100000000000000000000000000000000000000000000000000000000000000000000000000000000000000000000000000000000000000000000000000000000000000000000000000000000000000000000001
100000000000000000000000000000000000000000000000000000000000000000000000000000000000000000000000000000000000000000000000000000000000000000000000000000000000000000000001
100000000000000000000000000000000000000000000000000000000000000000000000000000000000000000000000000000000000000000000000000000000000000000000000000000000000000000000001
111000000001111111111111111111111111000000000000000000000000000000000000000000000000000000000000000000000000000000000000000000000000000000000000000000000000000000000001
100000000000000000000000000000000001000000000000000000000000000000000000000000011111111111111111111111111111111111111111111111000000000000000000000000000000000000000001
100000000000000000111111111111100001000000000000000000000000000000000000000000000000000000000000000000000100000000000000000000000000000000000000000000000000000000000001
100000000000000000100000000000100001000000000000000000000000000000000000000000000000000000000000000000000100000000000000000000000000000000000000000000000000000000000001
100000000000000000100000111111100001000000000000111111111111111110000000000000000000000000000000000000000100C11111111111111111111111100000000000000000000000000000000001
100000000000000000100C001000000000010000000000000000001C00C0000010000000000000000000000000000000000000000100000100000001000000000000000000000100000000111111111111111111
100000000000000000100000000000000001000000000000000000111110000010000000000000000000000000000000000000000100000100000001000000000000000000000100000000010001000100000001
1000000000000000011111111111111111110000C00000000000000000000000100000000000000000000000000000000000000001000111000000010000000000000000000001000000000001000100011000C1
100000000000000000000000000000000001111111111111111111111111111110000000000000000000000000000000000000000100000000000001000000000000000000000111111111111111111111111111
10000000000000000000000000000000000000000000000000000000000000000000000000000000000000000000000000000000011111111111111100000000000000000000010000000000000000C100000001
100000000000000000000000000000000000000000000000000000000000000000000000000000000000000000000000000000000000000000000000000000000000000000000100000000000000011100000001
100000000000000000000000000000000000000000000000000000000000000000000000000000000000000000000000000000000000000000000000000000000000000000000100000000000000000000000001
100000000000000000000000000000000000000000000000000000000000000000000000000000000000000000000000000000000000000000000000000000000000000000000000000000000000000000000001
100000000000000000000000000000000000000000000000000000000000000000000000000000000000000000000000000001111111111111111111111111111111111111111111111111111111111111111111
111000000001111111111111111111111111000000000000000000000000000000000000000000000000000000000000000000000000000000000000000000000000000000000000000000000000000000000001
100000000000000000000000000000000001000000000000000000000000000000000000000000011111111111111111111111111111111111111111111111000000000000000000000000000000000000000001
100000000000000000111111111111100001000000000000000000000000000000000000000000000000000000000000000000000100000000000000000000000000000000000000000000000000000000000001
100000000000000000100000000000100001000000000000000000000000000000000000000000000000000000000000000000000100000000000000000000000000000000000000000000000000000000000001
100000000000000000100000111111100001000000000000111111111111111110000000000000000000000000000000000000000100C11111111111111111111111100000000000000000000000000000000001
100000000000000000100C001000000000010000000000000000001C00C0000010000000000000000000000000000000000000000100000100000001000000000000000000000100000000111111111111111111
100000000000000000100000000000000001000000000000000000111110000010000000000000000000000000000000000000000100000100000001000000000000000000000100000000010001000100000001
1000000000000000011111111111111111110000C00000000000000000000000100000000000000000000000000000000000000001000111000000010000000000000000000001000000000001000100011000C1
100000000000000000000000000000000001111111111111111111111111111110000000000000000000000000000000000000000100000000000001000000000000000000000111111111111111111111111111
10000000000000000000000000000000000000000000000000000000000000000000000000000000000000000000000000000000011111111111111100000000000000000000010000000000000000C100000001
100000000000000000000000000000000000000000000000000000000000000000000000000000000000000000000000000000000000000000000000000000000000000000000100000000000000011100000001
100000000000000000000000000000000000000000000000000000000000000000000000000000000000000000000000000000000000000000000000000000000000000000000100000000000000000000000001
100000000000000000000000000000000000000000000000000000000000000000000000000000000000000000000000000000000000000000000000000000000000000000000000000000000000000000000001
100000000000000000000000000000000000000000000000000000000000000000000000000000000000000000000000000001111111111111111111111111111111111111111111111111111111111111111111
111000000001111111111111111111111111000000000000000000000000000000000000000000000000000000000000000000000000000000000000000000000000000000000000000000000000000000000001
100000000000000000000000000000000001000000000000000000000000000000000000000000011111111111111111111111111111111111111111111111000000000000000000000000000000000000000001
100000000000000000111111111111100001000000000000000000000000000000000000000000000000000000000000000000000100000000000000000000000000000000000000000000000000000000000001
100000000000000000100000000000100001000000000000000000000000000000000000000000000000000000000000000000000100000000000000000000000000000000000000000000000000000000000001
100000000000000000100000111111100001000000000000111111111111111110000000000000000000000000000000000000000100C11111111111111111111111100000000000000000000000000000000001
100000000000000000100C001000000000010000000000000000001C00C0000010000000000000000000000000000000000000000100000100000001000000000000000000000100000000111111111111111111
100000000000000000100000000000000001000000000000000000111110000010000000000000000000000000000000000000000100000100000001000000000000000000000100000000010001000100000001
1000000000000000011111111111111111110000C00000000000000000000000100000000000000000000000000000000000000001000111000000010000000000000000000001000000000001000100011000C1
100000000000000000000000000000000001111111111111111111111111111110000000000000000000000000000000000000000100000000000001000000000000000000000111111111111111111111111111
10000000000000000000000000000000000000000000000000000000000000000000000000000000000000000000000000000000011111111111111100000000000000000000010000000000000000C100000001
100000000000000000000000000000000000000000000000000000000000000000000000000000000000000000000000000000000000000000000000000000000000000000000100000000000000011100000001
100000000000000000000000000000000000000000000000000000000000000000000000000000000000000000000000000000000000000000000000000000000000000000000100000000000000000000000001
100000000000000000000000000000000000000000000000000000000000000000000000000000000000000000000000000000000000000000000000000000000000000000000000000000000000000000000001
100000000000000000000000000000000000000000000000000000000000000000000000000000000000000000000000000001111111111111111111111111111111111111111111111111111111111111111111
100000000000000000000000000000000000000000000000000000000000000000000000000000000000000000000000000000000000000000000000000000000000000000000000000000000000000000000001
111000000001111111111111111111111111000000000000000000000000000000000000000000000000000000000000000000000000000000000000000000000000000000000000000000000000000000000001
100000000000000000000000000000000001000000000000000000000000000000000000000000011111111111111111111111111111111111111111111111000000000000000000000000000000000000000001
100000000000000000111111111111100001000000000000000000000000000000000000000000000000000000000000000000000100000000000000000000000000000000000000000000000000000000000001
100000000000000000100000000000100001000000000000000000000000000000000000000000000000000000000000000000000100000000000000000000000000000000000000000000000000000000000001
100000000000000000100000111111100001000000000000111111111111111110000000000000000000000000000000000000000100C11111111111111111111111100000000000000000000000000000000001
100000000000000000100C001000000000010000000000000000001C00C0000010000000000000000000000000000000000000000100000100000001000000000000000000000100000000111111111111111111
100000000000000000100000000000000001000000000000000000111110000010000000000000000000000000000000000000000100000100000001000000000000000000000100000000010001000100000001
1000000000000000011111111111111111110000C00000000000000000000000100000000000000000000000000000000000000001000111000000010000000000000000000001000000000001000100011000C1
100000000000000000000000000000000001111111111111111111111111111110000000000000000000000000000000000000000100000000000001000000000000000000000111111111111111111111111111
10000000000000000000000000000000000000000000000000000000000000000000000000000000000000000000000000000000011111111111111100000000000000000000010000000000000000C100000001
100000000000000000000000000000000000000000000000000000000000000000000000000000000000000000000000000000000000000000000000000000000000000000000100000000000000011100000001
100000000000000000000000000000000000000000000000000000000000000000000000000000000000000000000000000000000000000000000000000000000000000000000100000000000000000000000001
100000000000000000000000000000000000000000000000000000000000000000000000000000000000000000000000000000000000000000000000000000000000000000000000000000000000000000000001
100000000000000000000000000000000000000000000000000000000000000000000000000000000000000000000000000001111111111111111111111111111111111111111111111111111111111111111111
100000000000000000000000000000000000000000000000000000000000000000000000000000000000000000000000000000000000000000000000000000000000000000000000000000000000000000000001
111000000001111111111111111111111111000000000000000000000000000000000000000000000000000000000000000000000000000000000000000000000000000000000000000000000000000000000001
100000000000000000000000000000000001000000000000000000000000000000000000000000011111111111111111111111111111111111111111111111000000000000000000000000000000000000000001
100000000000000000111111111111100001000000000000000000000000000000000000000000000000000000000000000000000100000000000000000000000000000000000000000000000000000000000001
100000000000000000100000000000100001000000000000000000000000000000000000000000000000000000000000000000000100000000000000000000000000000000000000000000000000000000000001
100000000000000000100000111111100001000000000000111111111111111110000000000000000000000000000000000000000100C11111111111111111111111100000000000000000000000000000000001
100000000000000000100C001000000000010000000000000000001C00C0000010000000000000000000000000000000000000000100000100000001000000000000000000000100000000111111111111111111
100000000000000000100000000000000001000000000000000000111110000010000000000000000000000000000000000000000100000100000001000000000000000000000100000000010001000100000001
1000000000000000011111111111111111110000C00000000000000000000000100000000000000000000000000000000000000001000111000000010000000000000000000001000000000001000100011000C1
100000000000000000000000000000000001111111111111111111111111111110000000000000000000000000000000000000000100000000000001000000000000000000000111111111111111111111111111
10000000000000000000000000000000000000000000000000000000000000000000000000000000000000000000000000000000011111111111111100000000000000000000010000000000000000C100000001
100000000000000000000000000000000000000000000000000000000000000000000000000000000000000000000000000000000000000000000000000000000000000000000100000000000000011100000001
100000000000000000000000000000000000000000000000000000000000000000000000000000000000000000000000000000000000000000000000000000000000000000000100000000000000000000000001
100000000000000000000000000000000000000000000000000000000000000000000000000000000000000000000000000000000000000000000000000000000000000000000000000000000000000000000001
100000000000000000000000000000000000000000000000000000000000000000000000000000000000000000000000000001111111111111111111111111111111111111111111111111111111111111111111
100000000000000000000000000000000000000000000000000000000000000000000000000000000000000000000000000000000000000000000000000000000000000000000000000000000000000000000001
111000000001111111111111111111111111000000000000000000000000000000000000000000000000000000000000000000000000000000000000000000000000000000000000000000000000000000000001
100000000000000000000000000000000001000000000000000000000000000000000000000000011111111111111111111111111111111111111111111111000000000000000000000000000000000000000001
100000000000000000111111111111100001000000000000000000000000000000000000000000000000000000000000000000000100000000000000000000000000000000000000000000000000000000000001
100000000000000000100000000000100001000000000000000000000000000000000000000000000000000000000000000000000100000000000000000000000000000000000000000000000000000000000001
100000000000000000100000111111100001000000000000111111111111111110000000000000000000000000000000000000000100C11111111111111111111111100000000000000000000000000000000001
100000000000000000100C001000000000010000000000000000001C00C0000010000000000000000000000000000000000000000100000100000001000000000000000000000100000000111111111111111111
100000000000000000100000000000000001000000000000000000111110000010000000000000000000000000000000000000000100000100000001000000000000000000000100000000010001000100000001
1000000000000000011111111111111111110000C00000000000000000000000100000000000000000000000000000000000000001000111000000010000000000000000000001000000000001000100011000C1
100000000000000000000000000000000001111111111111111111111111111110000000000000000000000000000000000000000100000000000001000000000000000000000111111111111111111111111111
10000000000000000000000000000000000000000000000000000000000000000000000000000000000000000000000000000000011111111111111100000000000000000000010000000000000000C100000001
100000000000000000000000000000000000000000000000000000000000000000000000000000000000000000000000000000000000000000000000000000000000000000000100000000000000011100000001
100000000000000000000000000000000000000000000000000000000000000000000000000000000000000000000000000000000000000000000000000000000000000000000100000000000000000000000001
100000000000000000000000000000000000000000000000000000000000000000000000000000000000000000000000000000000000000000000000000000000000000000000000000000000000000000000001
100000000000000000000000000000000000000000000000000000000000000000000000000000000000000000000000000001111111111111111111111111111111111111111111111111111111111111111111
100000000000000000000000000000000000000000000000000000000000000000000000000000000000000000000000000000000000000000000000000000000000000000000000000000000000000000000001
111000000001111111111111111111111111000000000000000000000000000000000000000000000000000000000000000000000000000000000000000000000000000000000000000000000000000000000001
100000000000000000000000000000000001000000000000000000000000000000000000000000011111111111111111111111111111111111111111111111000000000000000000000000000000000000000001
100000000000000000111111111111100001000000000000000000000000000000000000000000000000000000000000000000000100000000000000000000000000000000000000000000000000000000000001
100000000000000000100000000000100001000000000000000000000000000000000000000000000000000000000000000000000100000000000000000000000000000000000000000000000000000000000001
100000000000000000100000111111100001000000000000111111111111111110000000000000000000000000000000000000000100C11111111111111111111111100000000000000000000000000000000001
100000000000000000100C001000000000010000000000000000001C00C0000010000000000000000000000000000000000000000100000100000001000000000000000000000100000000111111111111111111
100000000000000000100000000000000001000000000000000000111110000010000000000000000000000000000000000000000100000100000001000000000000000000000100000000010001000100000001
1000000000000000011111111111111111110000C00000000000000000000000100000000000000000000000000000000000000001000111000000010000000000000000000001000000000001000100011000C1
100000000000000000000000000000000001111111111111111111111111111110000000000000000000000000000000000000000100000000000001000000000000000000000111111111111111111111111111
10000000000000000000000000000000000000000000000000000000000000000000000000000000000000000000000000000000011111111111111100000000000000000000010000000000000000C100000001
100000000000000000000000000000000000000000000000000000000000000000000000000000000000000000000000000000000000000000000000000000000000000000000100000000000000011100000001
100000000000000000000000000000000000000000000000000000000000000000000000000000000000000000000000000000000000000000000000000000000000000000000100000000000000000000000001
1E0000000000000000000000000000000000000000000000000000000000000000000000000000000000000000000000000000000000000000000000000000000000000000000000000000000000000000000001
111111111111111111111111111111111111111111111111111111111111111111111111111111111111111111111111111111111111111111111111111111111111111111111111111111111111111111111111
100000000000000000000000000000000000000000000000000000000000000000000000000000000000000000000000000001111111111111111111111111111111111111111111111111111111111111111111
100000000000000000000000000000000000000000000000000000000000000000000000000000000000000000000000000000000000000000000000000000000000000000000000000000000000000000000001
111000000001111111111111111111111111000000000000000000000000000000000000000000000000000000000000000000000000000000000000000000000000000000000000000000000000000000000001
100000000000000000000000000000000001000000000000000000000000000000000000000000011111111111111111111111111111111111111111111111000000000000000000000000000000000000000001
100000000000000000111111111111100001000000000000000000000000000000000000000000000000000000000000000000000100000000000000000000000000000000000000000000000000000000000001
100000000000000000100000000000100001000000000000000000000000000000000000000000000000000000000000000000000100000000000000000000000000000000000000000000000000000000000001
100000000000000000100000111111100001000000000000111111111111111110000000000000000000000000000000000000000100C11111111111111111111111100000000000000000000000000000000001
100000000000000000100C001000000000010000000000000000001C00C0000010000000000000000000000000000000000000000100000100000001000000000000000000000100000000111111111111111111
100000000000000000100000000000000001000000000000000000111110000010000000000000000000000000000000000000000100000100000001000000000000000000000100000000010001000100000001
1000000000000000011111111111111111110000C00000000000000000000000100000000000000000000000000000000000000001000111000000010000000000000000000001000000000001000100011000C1
100000000000000000000000000000000001111111111111111111111111111110000000000000000000000000000000000000000100000000000001000000000000000000000111111111111111111111111111
10000000000000000000000000000000000000000000000000000000000000000000000000000000000000000000000000000000011111111111111100000000000000000000010000000000000000C100000001
100000000000000000000000000000000000000000000000000000000000000000000000000000000000000000000000000000000000000000000000000000000000000000000100000000000000011100000001
100000000000000000000000000000000000000000000000000000000000000000000000000000000000000000000000000000000000000000000000000000000000000000000100000000000000000000000011
1000000000000000000000000000000000000000000000000000000000000000000000000000000000000000000000000000000000000000000000000000000000000000000000000000000000000000000000C1
111111111111111111111111111111111111111111111111111111111111111111111111111111111111111111111111111111111111111111111111111111111111111111111111111111111111111111111111
