111111111111
1P0000000E01
1000C0000001
111111111111
