111111111111
1PC0000000E1
1C00C0000001
111111111111
