1111111111111111111
1C000000100000000C1
1001110010001111001
1001000010000001001
1001011111111001001
10000000EP000000001
1001011111111001001
1001000010000001001
1001110010000111001
1C000000100000000C1
1111111111111111111
